###########
   #  P#Y
 # # # #
 # # # #
 # # # #
 # # # #
 #   # #  Y
 #P G#B   #
 ##########