###########
BBBBBBBBBBB
YYYYYYYYYYY
GGGGGGGGGGG
PPPPPPPPPPP