###########
    #     G
 #G #  #
 #  #G #
 #  #  #B
 # Y#  #
 #    B#  Y
 #P    #  #
 ##########