    ###
   #####
   #####
  ##B#B##
 ##BB#BB##
 #BBBBBBB#
 #BBBBBBB#
 BBBBBBBBB
BBBBBBBBBBB