
YYYYYYYYYYY
YYYYYYYYYYY

P# #PPP# #P
P# #PPP# #P
P# #PPP# #P

BBBBBBBBBBB
BBBBBBBBBBB