PPPPPPPPPPP
GGGGGGGGGGG
YYYY###YYYY
YGGY   YPPY
YGGY    PPY
Y         Y
Y  YBBBY  Y
Y  YBBBY  Y
Y###YYY###Y